NO res/BIGLEAVES.xpm
SO res/GOLDROCKS.xpm
EA res/LAVAROCKS.xpm
WE res/WATER.xpm

F 255, 0, 0
C 255, 0, 255

11111
111N1
11111

11111
10011
11111